......##.....##....##......
###..^^...#####..^..##...#.
#..^..###.....^...##...^#..
..##....^..###..^...##....^
#.^^..##....^...#.#.^...#..
....^^.#.^..###.^^....^.^..
.^##^....^^....^###^...##..
..^......##^^....^^..#..^..
###...^...^...##^^...^....#
.......^...^.....^........*