.............##....##......
..^..^^.#.^..^...^..##...#.
...^..###.....^...##...^...
..##....^..###..^...##..^..
..^^..##....^...#.#.^...#..
....^^.#.^..###.^^....^.^..
.^.#.^...^^...^.###.^..##..
..^......##.^....^^..#..^..
.##...^...^...##.^^..^.....
.......^...^.....^.......*.