......##.....##....##......
.##..^^...#####..^..##...#.
...^..###.....^...##...^#..
..##....^..###..^...##....^
..^^..##....^...#.#.^...#..
....^^.#.^..###.^^....^.^..
.^##^....^^....^###^...##..
..^......##^^....^^..#..^..
.##...^...^...##^^...^.....
.......^...^.....^.......*.