....##^^^...##.^...^###...^
...^...^.....^^...^^..^.##.
.^###.^.^^..^...#..^..^...^
.###.^^..^.^.^...^^.^^.^.^.
...^.^..^^.#..^^^#..^^.^...
....^..^..^^..##.^..^.^^...
..^.#.^^.^..^...^..^.#.^...
^^^...^^...^.##.^.^^.^...^.
.##.^.^^..^.^.^..^^...^.^..
..^^..^^...^...^..^..^...*.




