....##^^^...##.^...^###...^
...^...^.....^^...^^..^.##.
.^###.^.^^..^...#..^..^...^
####.^^..^.^.^...^^.^^.^.^#
...^.^..^..###..^^^#..^^.^.
.^.##.^^.^...^..^^....^.^.#
....^...^.^^.###.^.^.^...^.
^^..^##..^...^....^.#^.....
#.^.^....^.#..^..^.....^.##
^^^##^...^...^...##^...^^..
..^.#.^....^^^....^.^.^..##
...^..^.^..^^##...^...^.^..
.^###...^.^....^..^..^.##.^
^^^..^.^.^...^^.#.^.^.^....
###.^..^^.^....^..^.^.^.##.
....^..^..^^..##.^..^.^^...
..^.###.^^.^..^...^..^.##.^
^^^...^^...^.##.^.^^.^...^.
###.^.^^..^.^....^^...^.^..
..^^..^^...^...^..^..^....*




