##...^^^...##.^...^###...^.
...^.^.^.....^^...^^..^.##.
.^###.^.^^..^...#..^.^^...^
####.^^..^.^.^...^^.^^.^.^#
...^.^..^..###..^^^#..^^.^.
.^.##.^^.^...^..^^....^.^.#
....^...^.^^.###.^.^.^...^.

