.....^....^..^^...#^.....^.
.#.^^.....^....^^...##..^..
...#^^...^^##^^.^.^.....^^.
..^^.....^^....^..###.....^
...^##.^^..^^....^....^^.#.
..^^.##..^^..^^.....^.^.##.
^^^....^^.^#^...^##.^.^^..^
.##...^.^^..^##..##.^.^....
^^^..^....^.##.^^.^..^.^^^.
....^...^...^...^^....^..*.


