....####^^^###...####......
...^^.....^....^^^...##..^.
...###...^^##^^...^.....^^#
..^^.....^^....^..###.....^
...###.^^..^^....^....^^.#.
.^^....^^...^.^.##.^^...^..
..###^^....^^...^...^^.##..
..^.^.^.^.##...^^#^.^.^....
..^^###..^^..^^.....^.^.##.
^^^....^^.^#^...###.^.^^..^
###...^.^^..^##..##.^.^....
.....^.^^##^..^..^^.^...#..
..###^...^...^^..###..^^..^
^^^..^....^.##.^^.^..^.^^^.
....^...^...^...^^....^...*


