...^^.....^....^^...##..^..
.....^....^..^^...#^.....^.
...#^^...^^##^^.^.......^^.
..^^.....^^....^..###.....^
...^##.^^..^^....^....^^.#.
..^^.##..^^..^^.....^.^.^..
^^^....^^.^#^...^##.^.^^..^
.##...^.^^..^^^..^..^.^.#..
^^^..^....^.##.^^.^^.^...^.
....^...^...^...^^....^..*.


