....####^^^###...####......
...^^.....^....^^...##..^..
...###...^^##^^...^.....^^.
..^^.....^^....^..###.....^
...###.^^..^^....^....^^.#.
..^^###..^^..^^.....^.^.##.
^^^....^^.^#^...###.^.^^..^
.##...^.^^..^##..##.^.^....
^^^..^....^.##.^^.^..^.^^^.
....^...^...^...^^....^..*.


