....####...####..####......
###..^^...#####..^..##...#.
#..^..###.....^...##...^#..
..##....^..###..^...##....^
#.^^..##....^...###.^...#..
....^^.#.^..###.^^....^.^..
.^##^....^^....^###^...##..
..^....####^^....^^..#..^..
###...^...^...##^^...^....#
.......^...^.....^........*